##########
#P       #
#        #
#   M    #
#        #
#        #
#    M   #
#        #
#       G#
##########
